MELHOR JOGO DE CADA LETRA

# - 
A - A Way Out
B - Bayonetta
C - Celeste
D - Dark Souls 3
E - Evoland
F - Far Cry 3
G - God of War 2
H - Hollow Knight
I - ICO
J - Journey
K - Katana Zero
L - Left 4 Dead 2
M - Minecraft
N - 
O - Ori and the Blind Forest
P - Portal 2
Q -
R - Resident Evil 2
S - Shadow of the Colossus
T - Terraria
U - Undertale
V - Virtua Fighter 2
W - The Walking Dead
X -
Y - Yu-Gi-Oh Capsule Monster Colisseum
Z - The Lenend of Zelda: Majora's Mask


Minha Home do Site
Lista de Jogos

Meu Canal no Youtube
Minha Conta Steam
Meu RetroAch

Anilist
Letterbox
Instagram de Desenhos
Twitter